{
  "name": "Solo Climb",
  "bgColor":  [18, 18, 36],
  "skyColor": [40, 55, 100],
  "grid": [
    "                                                  ",
    "                                                  ",
    "                                                  ",
    "                                                  ",
    "                                                  ",
    "                                                  ",
    "                              D                   ",
    "                  K         ####                  ",
    "                ####      ##                      ",
    "              ##    S   ##                        ",
    "            ##    S   ##                          ",
    "          ##    S                                 ",
    "  1     ##      S                                 ",
    "##################################################",
    "##################################################"
  ],
  "movingPlatforms": []
}
