{
  "name": "Solo Gauntlet",
  "bgColor":  [6, 6, 16],
  "skyColor": [10, 10, 28],
  "grid": [
    "                                                                    ",
    "                                                                    ",
    "                                                                    ",
    "                                                                    ",
    "                                                                    ",
    "                                          K                         ",
    "                                        ####                        ",
    "                            ###                                     ",
    "            ###                                                     ",
    "  ###                 S S         S S S    D                        ",
    "######    1     ###  #####  ###    ###  #####   S S S               ",
    "#######  ###  #####       ######       #######  #####               ",
    "####################################################################",
    "####################################################################"
  ],
  "movingPlatforms": [
    { "x": 14, "y": 9, "width": 3, "move_axis": "x", "range": 6, "speed": 70 },
    { "x": 28, "y": 7, "width": 3, "move_axis": "y", "range": 3, "speed": 60 },
    { "x": 38, "y": 6, "width": 3, "move_axis": "x", "range": 6, "speed": 65 }
  ]
}
