{
  "name": "Duo Teamwork",
  "bgColor":  [18, 18, 36],
  "skyColor": [40, 55, 100],
  "grid": [
    "                                                  ",
    "                                                  ",
    "                                                  ",
    "                                                  ",
    "                                                  ",
    "                                                  ",
    "                  K                               ",
    "                ####          D                   ",
    "              ##      S     ####                  ",
    "            ##      S     ##                      ",
    "          ##      S     ##                        ",
    "  1 2           S                                 ",
    "######          S                                 ",
    "##################################################",
    "##################################################"
  ],
  "movingPlatforms": []
}
