{
  "name": "Duo Abyss",
  "bgColor":  [8, 8, 20],
  "skyColor": [14, 14, 38],
  "grid": [
    "                                                              ",
    "                                                              ",
    "                                              K               ",
    "                                            ####              ",
    "                                                              ",
    "                  ###                                         ",
    "                            ###                         ###   ",
    "       ###                                                    ",
    "                                                              ",
    "  ###         S S S                      D                    ",
    " #####       #######    1   2         ######   S S            ",
    "#######                             ########  #####           ",
    "##############################################################",
    "##############################################################"
  ],
  "movingPlatforms": [
    { "x": 17, "y": 7, "width": 3, "move_axis": "x", "range": 4, "speed": 90 },
    { "x": 28, "y": 5, "width": 3, "move_axis": "x", "range": 4, "speed": 80 },
    { "x": 44, "y": 6, "width": 3, "move_axis": "y", "range": 3, "speed": 70 }
  ]
}
