{
  "name": "Trio Peak",
  "bgColor":  [18, 18, 36],
  "skyColor": [40, 55, 100],
  "grid": [
    "                                                  ",
    "                                                  ",
    "                  K                               ",
    "                                                  ",
    "                                                  ",
    "                                                  ",
    "                                                  ",
    "                ####            D                 ",
    "              ##      S       ####                ",
    "            ##      S       ##                    ",
    "          ##      S       ##      S S             ",
    "  1 2 3         S               S S               ",
    "########        S                                 ",
    "######                                      ######",
    "##################################################"
  ],
  "movingPlatforms": []
}
