{
  "name": "Trio Stack",
  "bgColor":  [18, 18, 36],
  "skyColor": [40, 55, 100],
  "grid": [
    "                                                  ",
    "                                                  ",
    "                                                  ",
    "                                                  ",
    "                  K                               ",
    "                                                  ",
    "                                                  ",
    "                ####                              ",
    "              ##                                  ",
    "            ##    S     ###   D                   ",
    "  1 2 3           S   ##  #####                   ",
    "########          S ##                            ",
    "##################################################",
    "##################################################",
    "##################################################"
  ],
  "movingPlatforms": []
}
